#########
#       #
#S  C   #
#   X   #
#########
