    #    
   # #   
  #   #  
 #  C  #
#  X    #
# S  #  #
#       #
#########