######
#cS  #
#   c#
#c   #
######